8,9,9,9,9,9,9,9,9,9,9,9,9,9,9,9,9,9,9,9,9,9,9,9,9,9,9,9,9,9,9,9,9,9,9,9,9,9,9,9,9,9,9,9,9,9,9,9,9,8
8,0,0,0,0,0,0,0,0,7,7,0,0,0,0,0,0,0,0,0,0,0,0,0,1,1,0,7,0,0,0,0,0,0,0,0,0,0,0,0,0,0,0,7,0,0,0,0,0,8
8,0,7,0,0,0,0,0,0,7,0,0,0,0,0,0,7,0,0,7,0,0,0,0,1,1,0,0,0,0,0,0,0,7,7,0,0,0,0,0,0,0,0,0,0,0,0,0,0,8
8,0,0,0,7,0,7,0,0,0,0,0,7,0,0,0,0,0,7,0,0,0,0,0,1,1,0,0,0,0,0,7,0,0,0,0,0,0,0,0,0,7,0,0,0,0,0,0,7,8
8,0,0,0,0,0,0,0,0,7,0,0,0,0,0,0,0,0,0,0,0,0,7,0,1,1,0,0,0,0,0,0,0,0,0,0,0,0,0,0,0,0,0,0,0,0,0,0,0,8
8,0,0,0,0,10,10,10,10,10,10,10,10,10,10,0,0,0,0,0,7,0,0,0,1,1,0,0,0,0,0,0,0,0,0,10,10,10,10,10,10,10,10,10,10,0,0,0,0,8
8,0,0,0,0,10,10,10,10,10,10,10,10,10,10,0,0,0,0,0,10,10,10,10,1,1,10,10,10,10,0,7,0,0,0,10,10,10,10,10,10,10,10,10,10,0,0,0,0,8
8,0,7,0,0,10,10,10,10,10,10,10,10,10,10,0,0,0,0,0,10,10,10,10,1,1,10,10,10,10,7,0,0,0,0,10,10,10,10,10,10,10,10,10,10,0,0,0,0,8
8,0,0,0,0,10,10,10,10,10,10,10,10,10,10,0,0,0,0,0,10,10,10,10,1,1,10,10,10,10,0,0,0,0,0,10,10,10,10,10,10,10,10,10,10,0,0,0,0,8
8,0,7,0,0,10,10,10,10,10,10,10,10,10,10,0,0,0,0,0,10,10,10,10,1,1,10,10,10,10,0,0,0,0,0,10,10,10,10,10,10,10,10,10,10,0,0,0,0,8
8,0,0,0,0,0,0,0,0,0,0,0,0,0,0,0,0,0,0,0,10,10,10,10,1,1,10,10,10,10,0,0,0,0,0,0,0,0,0,0,0,0,7,0,0,0,0,0,0,8
8,0,0,0,0,0,0,0,0,0,0,0,0,0,7,0,0,0,0,0,10,10,10,10,1,1,10,10,10,10,0,0,0,0,0,0,0,0,0,0,0,0,0,0,0,7,0,0,0,8
8,0,0,0,0,0,0,0,0,0,0,0,0,0,0,0,0,0,0,0,0,0,0,0,1,1,7,0,0,0,0,0,0,0,7,0,0,7,0,0,7,0,0,7,0,0,0,7,0,8
8,0,0,0,0,0,0,7,0,0,0,0,7,0,0,0,0,0,0,0,0,0,0,0,1,1,0,0,0,0,0,7,7,0,7,0,0,0,0,0,0,0,0,0,0,0,0,7,0,8
8,0,0,0,0,0,0,0,0,0,0,0,0,0,7,0,0,0,0,0,0,0,7,0,1,1,0,0,0,0,0,0,0,0,0,0,0,0,7,0,0,0,0,0,0,0,7,0,0,8
8,0,0,7,0,0,0,0,0,7,0,0,0,0,0,0,0,0,0,0,0,0,0,0,1,1,0,0,0,0,0,0,0,0,7,7,0,0,0,0,7,0,0,0,0,0,0,0,0,8
8,0,0,0,0,0,7,0,0,0,0,0,0,7,7,0,0,7,0,7,7,0,0,0,1,1,0,0,0,0,0,0,0,7,0,0,0,0,0,0,0,0,0,0,0,0,0,0,7,8
8,0,0,0,0,0,0,0,0,0,0,0,0,0,0,0,7,0,0,0,0,7,0,0,1,1,0,7,0,0,0,0,0,0,0,0,0,7,0,0,0,0,0,0,7,0,0,0,7,8
8,0,0,0,7,0,0,0,0,0,0,0,0,0,0,0,0,0,0,0,0,0,0,0,1,1,0,0,0,0,0,0,7,0,7,0,0,0,0,7,7,0,0,0,0,0,0,0,0,8
8,7,0,0,0,0,0,0,0,0,0,0,0,0,0,0,7,0,7,0,0,7,0,0,1,1,0,7,0,0,0,0,0,0,7,0,0,0,0,7,0,0,0,0,0,0,0,0,0,8
8,2,2,2,2,2,2,2,2,2,2,2,2,2,2,2,2,2,2,2,2,2,2,2,2,2,2,2,2,2,2,2,2,2,2,2,2,2,2,2,2,2,2,2,2,2,2,2,2,8
8,2,2,2,2,2,2,2,2,2,2,2,2,2,2,2,2,2,2,2,2,2,2,2,2,2,2,2,2,2,2,2,2,2,2,2,2,2,2,2,2,2,2,2,2,2,2,2,2,8
8,2,2,2,2,2,2,2,2,2,2,2,2,2,2,2,2,2,2,2,2,2,2,2,2,2,2,2,2,2,2,2,2,2,2,2,2,2,2,2,2,2,2,2,2,2,2,2,2,8
8,0,0,0,0,0,0,0,0,0,0,0,0,0,0,0,7,0,0,0,7,0,0,0,1,1,0,0,0,0,0,7,0,7,0,0,0,0,0,0,0,0,0,0,0,7,7,0,0,8
8,0,7,0,0,0,7,0,0,0,0,0,0,0,0,0,0,0,0,0,0,7,0,0,1,1,0,0,0,0,0,0,0,0,0,0,0,0,0,0,0,0,0,0,0,0,0,0,0,8
8,0,0,0,0,0,0,0,0,0,0,0,7,0,0,0,0,0,0,0,0,0,0,0,1,1,0,0,0,7,0,0,0,7,0,0,0,0,0,0,0,7,0,0,0,0,0,0,0,8
8,0,0,0,0,0,0,0,0,0,0,0,0,0,0,0,0,0,0,0,0,0,0,0,1,1,0,0,7,0,0,7,0,0,0,7,0,0,0,0,7,0,0,0,0,0,0,0,0,8
8,0,0,7,0,0,0,0,0,0,0,0,0,7,0,0,7,0,0,7,0,0,0,7,1,1,0,0,0,0,0,0,0,0,7,0,0,0,0,0,0,0,0,0,7,0,0,0,0,8
8,0,7,0,0,0,0,0,0,0,0,0,0,0,7,0,0,0,0,0,0,0,0,0,1,1,0,0,7,7,0,0,0,0,0,0,0,0,0,0,0,0,0,0,0,0,0,0,0,8
8,7,0,0,0,0,7,0,0,0,0,7,0,7,0,0,0,0,0,0,0,0,0,0,1,1,0,0,7,0,0,0,0,0,0,0,0,0,0,0,0,0,0,0,0,0,0,0,0,8
8,0,0,0,0,3,3,3,3,4,0,0,0,4,0,0,0,0,0,0,5,5,5,5,5,5,5,5,5,5,0,0,0,0,0,4,3,3,0,7,0,0,4,3,3,0,0,0,0,8
8,0,0,0,0,7,0,4,0,4,7,0,3,3,3,0,0,0,0,0,5,6,6,6,6,6,6,6,6,5,0,0,0,0,0,0,7,3,4,0,4,4,4,3,3,0,0,0,0,8
8,0,0,0,7,0,3,4,3,3,4,3,3,3,4,0,0,0,0,0,5,6,6,6,6,6,6,6,6,5,0,0,0,0,7,0,3,4,4,3,0,4,0,3,3,0,0,0,0,8
8,7,0,0,0,3,0,4,0,4,4,3,3,4,0,0,0,0,0,0,5,6,6,6,6,6,6,6,6,5,0,0,7,0,0,0,3,4,3,3,0,4,0,0,4,0,0,0,0,8
8,0,0,0,0,0,4,0,0,3,3,0,4,4,0,0,0,0,7,0,5,5,5,5,5,5,5,5,5,5,0,0,0,0,0,3,3,0,4,0,4,0,3,4,7,0,0,0,0,8
8,0,0,0,0,3,0,0,0,3,0,4,0,3,3,0,0,0,0,0,7,0,7,0,1,1,0,0,0,0,0,0,0,7,0,0,4,3,3,3,4,7,3,3,3,0,0,0,0,8
8,0,0,0,7,3,0,7,3,0,3,3,3,3,3,0,0,0,7,7,0,0,0,0,1,1,0,0,0,7,0,0,0,0,0,0,4,4,0,4,0,4,3,4,4,0,0,0,7,8
8,7,0,0,0,3,4,4,4,4,3,0,0,0,0,0,0,0,0,0,0,0,0,0,1,1,0,0,0,0,0,0,0,7,0,3,0,0,0,4,4,0,3,3,4,0,0,0,0,8
8,0,0,0,0,0,4,0,0,4,3,0,4,4,0,0,0,0,0,0,0,0,0,0,1,1,0,0,0,7,7,7,0,0,7,3,0,4,0,0,4,4,0,3,0,0,0,0,0,8
8,0,0,0,0,4,3,3,7,7,7,0,4,4,3,0,0,0,0,0,0,0,0,0,1,1,0,0,0,0,0,0,0,0,0,4,3,0,4,4,3,3,4,0,0,0,0,0,7,8
8,0,0,0,7,0,0,0,0,0,0,0,0,0,0,0,0,0,0,0,0,0,0,0,1,1,0,0,0,0,0,0,0,0,0,0,7,0,0,0,0,0,0,0,0,0,0,0,7,8
8,0,0,7,0,0,0,7,0,0,0,0,0,0,0,7,0,7,0,0,0,7,0,0,1,1,0,0,0,7,0,0,7,0,0,0,7,0,0,0,0,0,0,0,0,0,0,0,0,8
8,0,0,0,0,0,0,0,0,0,0,0,0,0,0,0,0,0,0,0,0,0,0,0,1,1,0,0,0,0,0,0,0,0,0,0,0,0,0,7,0,0,0,0,0,0,0,0,0,8
8,0,0,0,0,0,0,0,0,0,0,0,0,0,0,0,0,0,7,0,0,0,0,0,1,1,0,0,0,7,0,0,0,0,0,0,0,0,0,0,0,0,7,0,0,0,0,0,0,8
8,7,7,0,0,0,0,0,0,0,0,0,0,0,0,0,0,0,0,0,0,0,0,7,1,1,0,0,0,0,0,0,0,0,0,0,0,0,7,0,0,0,0,0,7,0,0,0,0,8
8,0,0,0,0,0,0,0,0,0,0,0,0,0,0,0,0,0,0,0,0,0,0,0,1,1,7,0,0,0,0,0,0,0,7,0,0,0,0,0,0,0,0,0,0,0,0,0,0,8
8,0,0,0,0,0,0,7,0,0,0,7,0,0,0,0,0,0,0,0,0,0,0,0,1,1,0,0,0,0,0,0,0,0,0,0,0,0,0,0,0,7,0,7,0,0,0,0,0,8
8,0,0,0,0,0,0,0,0,0,0,0,0,0,0,0,0,0,0,0,0,0,0,0,1,1,0,0,0,0,0,0,0,7,0,0,0,0,0,0,0,0,0,0,0,0,0,0,0,8
8,0,0,0,7,0,7,0,0,0,0,0,0,0,7,0,7,7,0,0,0,0,0,0,1,1,0,0,0,0,7,0,0,0,0,0,0,0,0,0,7,0,0,0,0,0,7,0,7,8
8,8,8,8,8,8,8,8,8,8,8,8,8,8,8,8,8,8,8,8,8,8,8,8,8,8,8,8,8,8,8,8,8,8,8,8,8,8,8,8,8,8,8,8,8,8,8,8,8,8